EST	= "countries/Estonia.txt"
FIN = "countries/Finland.txt"
UKR	= "countries/Ukraine.txt"
SVU = "countries/Soviet_Ukraine.txt"
MAK = "countries/Makhnovia"
ENU = "countries/Entente_Ukraine.txt"
PNR = "countries/Provisional_North_West.txt"
TRC = "countries/Transcaspia.txt"
LBY = "countries/Lithuanian-Byelorussian_Soviet.txt"
USS = "countries/Ussuri_Cossack.txt"
PNR = "countries/Provisional_North_West"
BAI = "countries/Baikal_Cossacks.txt"
AMU = "countries/Amur.txt"
ZEM = "countries/Zemstvo_Regime.txt"
ZUN	= "countries/West_Ukraine.txt"
POL	= "countries/Poland.txt"
KHI	= "countries/Khiva.txt"
NMA	= "countries/Novo-Mariinsk.txt"
PAG = "countries/Provisional_All-Russian_Government.txt"
OKH = "countries/Okhotsk.txt"
CHU = "countries/Chukotka.txt"
ACD = "countries/Asiatic_Cavalry_Division.txt"
FEN = "countries/Fengtian_Clique.txt"
ANH = "countries/Anhui_Clique.txt"
ZHI = "countries/Zhili_Clique.txt"
NIN = "countries/Ninghai_Army.txt"
KRM = "countries/Crimea.txt"
GEO = "countries/Georgia.txt"
AZR = "countries/Azerbaijan.txt"
ARM = "countries/Armenia.txt"
LSR = "countries/Soviet_Latvia.txt"
LAN = "counries/Baltische_Landeswehr.txt"
FRE = "counries/Freikorps.txt"
LIT = "countries/Lithuania.txt"
LAT = "countries/Latvia.txt"
WRW = "countries/Bermontians.txt"
MNT = "countries/North_Caucasus.txt"
FRA = "countries/France.txt"
KUB = "countries/Kuban.txt"
DON = "countries/Don.txt"
SRU = "countries/South_Russia.txt"
SOV = "countries/Soviet_Russia.txt"
ORE = "countries/Orenburg.txt"
ALA = "countries/Alash_Autonomy.txt"
BUK = "countries/Bukhara.txt"
MAM = "countries/Mamontians.txt"
TUK = "countries/Tukrestan.txt"
PRI = "countries/Priargunsk.txt"
GER = "countries/Germany.txt"
LUX = "countries/Luxemburg.txt"
BEL = "countries/Belgium.txt"
NET = "countries/Holland.txt"
ITA = "countries/Italy.txt"
SPA = "countries/Spain.txt"
POR = "countries/Portugal.txt"
AUS = "countries/Austria.txt"